++++++++++++++++++++++
+  +   ++ +++       ++
+ S ++      +++ ++++++
+ +    ++  ++++ +++ ++
+ +   + + ++    + + ++
+          ++   +  +++
+++ + + +  +   ++  +++
+ +++ +++  + +  ++  ++
+          + +  + + ++
++ ++ +  + + +      ++
++ +++ +++++++++++++++